"id","name","pop","rank","mobilityscore","visafree","visaonarrival","visarequired"
"BE","Belgium","11372068","1","112","80","32","86"
"FI","Finland","5511303","1","112","79","33","86"
"AT","Austria","8809212","1","112","79","33","86"
"LU","Luxembourg","599449","1","112","79","33","86"
"ES","Spain","46572028","1","112","78","34","86"
"IE","Ireland","4813608","1","112","77","35","86"
"UK","United Kingdom","66022273","1","112","77","35","86"
"CH","Switzerland","8466017","1","112","76","36","86"
"SE","Sweden","10067744","2","111","79","32","87"
"NL","Netherlands","17132854","2","111","79","32","87"
"DK","Denmark","5769603","2","111","79","32","87"
"FR","France","67118648","2","111","79","32","87"
"DE","Germany","82695000","2","111","78","33","87"
"IT","Italy","60551416","2","111","78","33","87"
"NO","Norway","5282223","2","111","76","35","87"
"MT","Malta","465292","3","110","80","30","88"
"PT","Portugal","10293718","3","110","78","32","88"
"GR","Greece","10760421","3","110","77","33","88"
"IS","Iceland","341284","3","110","75","35","88"
"CZ","Czech Republic","10591323","4","109","77","32","89"
"SI","Slovenia","2066748","4","109","76","33","89"
"PL","Poland","37975841","4","109","76","33","89"
"HU","Hungary","9781127","4","109","76","33","89"
"LT","Lithuania","2827721","4","109","75","34","89"
"LI","Liechtenstein","37922","4","109","74","35","89"
"EE","Estonia","1315480","5","108","75","33","90"
"SK","Slovakia","5439892","5","108","75","33","90"
"LV","Latvia","1986705","5","108","75","33","90"
"MC","Monaco","38695","6","107","70","37","91"
"CY","Cyprus","1179551","7","106","77","29","92"
"RO","Romania","19586539","7","106","75","31","92"
"HR","Croatia","4125700","7","106","74","32","92"
"BG","Bulgaria","7075991","7","106","73","33","92"
"SM","San Marino","33400","8","103","72","31","95"
"AD","Andorra","76965","9","101","67","34","97"
"UA","Ukraine","44831159","10","98","62","36","100"
"VA","Vatican City","842","11","97","64","33","101"
"RS","Serbia","7022268","12","92","59","33","106"
"AE","United Arab Emirates","9400145","13","90","44","46","108"
"MK","North Macedonia","2083160","14","89","54","35","109"
"MD","Moldova","3549750","15","88","55","33","110"
"BA","Bosnia and Herzegovina","3507017","16","87","55","32","111"
"GE","Georgia","3717100","16","87","53","34","111"
"ME","Montenegro","622471","17","86","54","32","112"
"AL","Albania","2873457","17","86","52","34","112"
"US","United States of America","325719178","18","80","43","37","118"
"NZ","New Zealand","4793900","18","80","40","40","118"
"MY","Malaysia","31624264","19","79","45","34","119"
"JP","Japan","126785797","19","79","44","35","119"
"AU","Australia","24598933","19","79","39","40","119"
"SG","Singapore","5612253","20","78","52","26","120"
"KR","South Korea","51466201","20","78","43","35","120"
"CA","Canada","36708083","21","77","41","36","121"
"BR","Brazil","209288278","22","75","39","36","123"
"TR","Turkey","80745020","23","74","36","38","124"
"AR","Argentina","44271041","24","73","36","37","125"
"HK","Hong Kong","7391700","25","72","47","25","126"
"RU","Russian Federation","144495044","25","72","38","34","126"
"CL","Chile","18054726","25","72","36","36","126"
"BB","Barbados","285719","26","71","43","28","127"
"BS","Bahamas","395361","27","69","39","30","129"
"BN","Brunei","428697","27","69","36","33","129"
"SC","Seychelles","95843","28","68","42","26","130"
"KN","Saint Kitts and Nevis","55345","29","67","39","28","131"
"IL","Israel","8712400","29","67","33","34","131"
"MX","Mexico","129163276","29","67","30","37","131"
"MU","Mauritius","1264613","30","66","40","26","132"
"TT","Trinidad and Tobago","1369125","30","66","39","27","132"
"AG","Antigua and Barbuda","102012","30","66","37","29","132"
"MO","Macao","622567","30","66","36","30","132"
"UY","Uruguay","3456750","30","66","30","36","132"
"CR","Costa Rica","4905769","31","65","30","35","133"
"VC","St. Vincent and the Grenadines","109897","32","64","36","28","134"
"ZA","South Africa","56717156","32","64","34","30","134"
"QA","Qatar","2639211","32","64","31","33","134"
"KW","Kuwait","4136528","32","64","29","35","134"
"PE","Peru","32165485","32","64","26","38","134"
"JM","Jamaica","2890299","33","62","34","28","136"
"LC","Saint Lucia","178844","33","62","32","30","136"
"BZ","Belize","374681","34","61","36","25","137"
"FJ","Fiji","905502","34","61","28","33","137"
"TW","Taiwan","23415126","34","61","26","35","137"
"DM","Dominica","73925","35","60","30","30","138"
"VU","Vanuatu","276244","35","60","30","30","138"
"SB","Solomon Islands","611343","35","60","29","31","138"
"MV","Maldives","436330","35","60","28","32","138"
"PA","Panama","4098587","35","60","26","34","138"
"GD","Grenada","107825","36","59","32","27","139"
"TV","Tuvalu","11192","36","59","28","31","139"
"BH","Bahrain","1492584","36","59","24","35","139"
"VE","Venezuela","31977065","36","59","22","37","139"
"BW","Botswana","2291661","37","58","31","27","140"
"TO","Tonga","108020","37","58","28","30","140"
"TN","Tunisia","11532127","37","58","26","32","140"
"EC","Ecuador","16624858","37","58","22","36","140"
"PY","Paraguay","6811297","37","58","21","37","140"
"WS","Samoa","196440","38","57","25","32","141"
"KI","Kiribati","116398","38","57","25","32","141"
"SA","Saudi Arabia","32938213","38","57","22","35","141"
"RW","Rwanda","12208407","39","56","24","32","142"
"CN","China","1386395000","39","56","23","33","142"
"NI","Nicaragua","6217581","39","56","23","33","142"
"NR","Nauru","13649","39","56","23","33","142"
"OM","Oman","4636262","39","56","22","34","142"
"ID","Indonesia","263991379","39","56","22","34","142"
"LS","Lesotho","2233339","40","55","29","26","143"
"ZM","Zambia","17094130","40","55","28","27","143"
"GY","Guyana","777859","40","55","23","32","143"
"MH","Marshall Islands","53127","40","55","21","34","143"
"GH","Ghana","28833629","41","54","30","24","144"
"SZ","Eswatini","1367254","41","54","29","25","144"
"MW","Malawi","18622104","41","54","28","26","144"
"KE","Kenya","49699862","41","54","25","29","144"
"CU","Cuba","11484636","41","54","22","32","144"
"SV","El Salvador","6377853","41","54","22","32","144"
"HN","Honduras","9265067","41","54","22","32","144"
"CO","Colombia","49065615","41","54","21","33","144"
"BY","Belarus","9507875","41","54","20","34","144"
"KZ","Kazakhstan","18037646","41","54","19","35","144"
"BO","Bolivia","11051600","41","54","18","36","144"
"TZ","Tanzania","57310019","42","53","28","25","145"
"NA","Namibia","2533794","42","53","25","28","145"
"GT","Guatemala","16913503","42","53","20","33","145"
"FM","Micronesia","105544","42","53","18","35","145"
"TH","Thailand","69037513","42","53","16","37","145"
"ZW","Zimbabwe","16529904","43","52","27","25","146"
"CI","Cote d'Ivoire (Ivory Coast)","24294750","43","52","25","27","146"
"CV","Cape Verde","546388","43","52","24","28","146"
"UG","Uganda","42862958","43","52","24","28","146"
"AZ","Azerbaijan","9862429","43","52","21","31","146"
"SR","Suriname","563402","43","52","18","34","146"
"PW","Palau","21729","43","52","16","36","146"
"SN","Senegal","15850567","44","51","27","24","147"
"MA","Morocco","35739580","44","51","21","30","147"
"PG","Papua New Guinea","8251162","45","50","19","31","148"
"GM","Gambia","2100568","46","49","31","18","149"
"BJ","Benin","11175692","46","49","24","25","149"
"AM","Armenia","2930450","46","49","18","31","149"
"MZ","Mozambique","29668834","46","49","18","31","149"
"KG","Kyrgyzstan","6201500","46","49","15","34","149"
"SL","Sierra Leone","7557212","47","48","31","17","150"
"BF","Burkina Faso","19193382","47","48","24","24","150"
"GA","Gabon","2025137","47","48","18","30","150"
"UZ","Uzbekistan","32387200","47","48","16","32","150"
"DZ","Algeria","41318142","47","48","14","34","150"
"ST","Sao Tome and Principe","204327","47","48","14","34","150"
"DO","Dominican Republic","10766998","47","48","13","35","150"
"NE","Niger","21477348","48","47","25","22","151"
"MR","Mauritania","4420184","48","47","20","27","151"
"IN","India","1339180127","48","47","17","30","151"
"CM","Cameroon","24053727","48","47","17","30","151"
"PH","Philippines","104918090","48","47","16","31","151"
"MN","Mongolia","3075647","48","47","15","32","151"
"TJ","Tajikistan","8921343","48","47","15","32","151"
"ML","Mali","18541980","49","46","25","21","152"
"GW","Guinea-Bissau","1861283","49","46","23","23","152"
"GN","Guinea","12717176","49","46","22","24","152"
"TG","Togo","7797694","49","46","21","25","152"
"AO","Angola","29784193","49","46","18","28","152"
"GQ","Equatorial Guinea","1267689","49","46","15","31","152"
"JO","Jordan","9702353","49","46","14","32","152"
"MG","Madagascar","25570895","50","45","17","28","153"
"BI","Burundi","10864245","50","45","16","29","153"
"TM","Turkmenistan","5758075","50","45","12","33","153"
"TL","Timor-Leste","1296311","50","45","12","33","153"
"EG","Egypt","97553151","50","45","11","34","153"
"BT","Bhutan","807610","50","45","10","35","153"
"VN","Viet Nam","95540800","51","44","13","31","154"
"KH","Cambodia","16005373","51","44","11","33","154"
"LR","Liberia","4731906","52","43","22","21","155"
"TD","Chad","14899994","52","43","16","27","155"
"CF","Central African Republic","4659080","52","43","15","28","155"
"CG","Congo","5260750","53","42","12","30","156"
"LA","Laos","6858160","53","42","12","30","156"
"KM","Comoros","813912","53","42","10","32","156"
"HT","Haiti","10981229","53","42","10","32","156"
"NG","Nigeria","190886311","54","41","21","20","157"
"LK","Sri Lanka","21444000","54","41","12","29","157"
"CD","Congo (Dem. Rep.)","81339988","54","41","12","29","157"
"DJ","Djibouti","956985","54","41","11","30","157"
"SS","South Sudan","12575714","55","40","11","29","158"
"SD","Sudan","40533330","55","40","9","31","158"
"RK","Kosovo","1830700","56","39","12","27","159"
"ET","Ethiopia","104957438","56","39","10","29","159"
"NP","Nepal","29304998","56","39","9","30","159"
"BD","Bangladesh","164669751","57","38","12","26","160"
"LY","Libya","6374616","57","38","10","28","160"
"ER","Eritrea","4474690","57","38","9","29","160"
"KP","North Korea","25490965","57","38","8","30","160"
"LB","Lebanon","6082357","58","37","9","28","161"
"MM","Myanmar [Burma]","53370609","59","36","8","28","162"
"PK","Pakistan","197015955","60","34","7","27","164"
"PS","Palestinian Territories","4436411","61","33","7","26","165"
"IR","Iran","81162788","61","33","5","28","165"
"YE","Yemen","28250420","62","32","7","25","166"
"SO","Somalia","14742523","62","32","7","25","166"
"SY","Syria","18269868","63","31","6","25","167"
"AF","Afghanistan","35530081","64","28","4","24","170"
"IQ","Iraq","38274618","65","27","3","24","171"
