"id","name","pop","rank","mobilityscore","visafree","visaonarrival","visarequired"
"AE","United Arab Emirates","9400145","1","179","118","61","19"
"DE","Germany","82695000","2","172","128","44","26"
"FI","Finland","5511303","2","172","127","45","26"
"LU","Luxembourg","599449","2","172","127","45","26"
"ES","Spain","46572028","2","172","126","46","26"
"DK","Denmark","5769603","3","171","127","44","27"
"IT","Italy","60551416","3","171","127","44","27"
"NL","Netherlands","17132854","3","171","125","46","27"
"AT","Austria","8809212","3","171","125","46","27"
"PT","Portugal","10293718","3","171","125","46","27"
"CH","Switzerland","8466017","3","171","123","48","27"
"JP","Japan","126785797","3","171","123","48","27"
"KR","South Korea","51466201","3","171","121","50","27"
"IE","Ireland","4813608","3","171","120","51","27"
"US","United States of America","325719178","3","171","118","53","27"
"SE","Sweden","10067744","4","170","127","43","28"
"FR","France","67118648","4","170","127","43","28"
"BE","Belgium","11372068","4","170","125","45","28"
"MT","Malta","465292","4","170","124","46","28"
"GR","Greece","10760421","4","170","124","46","28"
"NO","Norway","5282223","4","170","123","47","28"
"SG","Singapore","5612253","5","169","131","38","29"
"CZ","Czech Republic","10591323","5","169","124","45","29"
"HU","Hungary","9781127","5","169","123","46","29"
"PL","Poland","37975841","5","169","122","47","29"
"LT","Lithuania","2827721","5","169","122","47","29"
"SK","Slovakia","5439892","5","169","122","47","29"
"UK","United Kingdom","66022273","5","169","120","49","29"
"CA","Canada","36708083","5","169","115","54","29"
"NZ","New Zealand","4793900","5","169","114","55","29"
"SI","Slovenia","2066748","6","168","122","46","30"
"EE","Estonia","1315480","6","168","122","46","30"
"IS","Iceland","341284","6","168","120","48","30"
"AU","Australia","24598933","6","168","111","57","30"
"LV","Latvia","1986705","7","167","122","45","31"
"CY","Cyprus","1179551","8","166","122","44","32"
"RO","Romania","19586539","8","166","118","48","32"
"MY","Malaysia","31624264","9","165","119","46","33"
"BG","Bulgaria","7075991","9","165","116","49","33"
"LI","Liechtenstein","37922","10","164","118","46","34"
"HR","Croatia","4125700","10","164","117","47","34"
"MC","Monaco","38695","10","164","112","52","34"
"CL","Chile","18054726","11","161","111","50","37"
"BR","Brazil","209288278","11","161","111","50","37"
"AR","Argentina","44271041","12","160","110","50","38"
"HK","Hong Kong","7391700","13","157","118","39","41"
"SM","San Marino","33400","14","154","109","45","44"
"AD","Andorra","76965","14","154","104","50","44"
"BN","Brunei","428697","15","153","106","47","45"
"IL","Israel","8712400","16","150","105","45","48"
"MX","Mexico","129163276","16","150","99","51","48"
"BB","Barbados","285719","17","149","110","39","49"
"UY","Uruguay","3456750","18","148","100","48","50"
"VA","Vatican City","842","19","146","100","46","52"
"BS","Bahamas","395361","20","145","104","41","53"
"KN","Saint Kitts and Nevis","55345","21","142","105","37","56"
"CR","Costa Rica","4905769","22","141","94","47","57"
"UA","Ukraine","44831159","22","141","92","49","57"
"VC","St. Vincent and the Grenadines","109897","23","140","101","39","58"
"PE","Peru","32165485","23","140","88","52","58"
"SC","Seychelles","95843","24","139","104","35","59"
"AG","Antigua and Barbuda","102012","24","139","101","38","59"
"MO","Macao","622567","24","139","95","44","59"
"TT","Trinidad and Tobago","1369125","25","138","100","38","60"
"PY","Paraguay","6811297","26","137","89","48","61"
"MU","Mauritius","1264613","27","136","100","36","62"
"PA","Panama","4098587","28","135","88","47","63"
"TW","Taiwan","23415126","28","135","84","51","63"
"LC","Saint Lucia","178844","29","134","94","40","64"
"RS","Serbia","7022268","29","134","86","48","64"
"GD","Grenada","107825","30","132","96","36","66"
"DM","Dominica","73925","31","131","91","40","67"
"SB","Solomon Islands","611343","31","131","87","44","67"
"VU","Vanuatu","276244","32","130","86","44","68"
"CO","Colombia","49065615","33","129","82","47","69"
"VE","Venezuela","31977065","33","129","79","50","69"
"HN","Honduras","9265067","34","128","83","45","70"
"GT","Guatemala","16913503","34","128","81","47","70"
"WS","Samoa","196440","35","127","85","42","71"
"SV","El Salvador","6377853","36","126","83","43","72"
"TV","Tuvalu","11192","37","125","83","42","73"
"TO","Tonga","108020","38","124","83","41","74"
"KI","Kiribati","116398","38","124","81","43","74"
"ME","Montenegro","622471","38","124","78","46","74"
"MK","North Macedonia","2083160","38","124","77","47","74"
"GE","Georgia","3717100","39","123","74","49","75"
"RU","Russian Federation","144495044","40","122","80","42","76"
"NI","Nicaragua","6217581","40","122","76","46","76"
"MH","Marshall Islands","53127","41","121","74","47","77"
"TR","Turkey","80745020","41","121","72","49","77"
"MD","Moldova","3549750","42","120","76","44","78"
"BA","Bosnia and Herzegovina","3507017","43","119","74","45","79"
"PW","Palau","21729","44","117","68","49","81"
"AL","Albania","2873457","45","116","70","46","82"
"FM","Micronesia","105544","45","116","67","49","82"
"ZA","South Africa","56717156","46","103","64","39","95"
"QA","Qatar","2639211","47","102","55","47","96"
"KW","Kuwait","4136528","47","102","53","49","96"
"TL","Timor-Leste","1296311","48","101","56","45","97"
"EC","Ecuador","16624858","49","98","49","49","100"
"BZ","Belize","374681","50","97","60","37","101"
"FJ","Fiji","905502","51","96","50","46","102"
"JM","Jamaica","2890299","52","94","56","38","104"
"MV","Maldives","436330","53","91","47","44","107"
"BH","Bahrain","1492584","53","91","45","46","107"
"GY","Guyana","777859","54","90","47","43","108"
"NR","Nauru","13649","55","89","44","45","109"
"TH","Thailand","69037513","55","89","39","50","109"
"OM","Oman","4636262","56","88","43","45","110"
"SA","Saudi Arabia","32938213","56","88","42","46","110"
"KZ","Kazakhstan","18037646","56","88","38","50","110"
"BY","Belarus","9507875","57","87","44","43","111"
"BO","Bolivia","11051600","58","86","38","48","112"
"ID","Indonesia","263991379","59","85","39","46","113"
"BW","Botswana","2291661","60","84","50","34","114"
"PG","Papua New Guinea","8251162","61","83","38","45","115"
"SR","Suriname","563402","62","82","38","44","116"
"LS","Lesotho","2233339","63","80","47","33","118"
"CN","China","1386395000","63","80","31","49","118"
"SZ","Eswatini","1367254","64","79","46","33","119"
"AZ","Azerbaijan","9862429","64","79","35","44","119"
"MW","Malawi","18622104","65","77","43","34","121"
"TN","Tunisia","11532127","65","77","36","41","121"
"AM","Armenia","2930450","66","76","34","42","122"
"CU","Cuba","11484636","66","76","30","46","122"
"DO","Dominican Republic","10766998","66","76","29","47","122"
"NA","Namibia","2533794","67","75","42","33","123"
"PH","Philippines","104918090","67","75","36","39","123"
"MN","Mongolia","3075647","67","75","32","43","123"
"TZ","Tanzania","57310019","68","74","43","31","124"
"ZM","Zambia","17094130","68","74","41","33","124"
"KE","Kenya","49699862","68","74","39","35","124"
"KG","Kyrgyzstan","6201500","68","74","29","45","124"
"MA","Morocco","35739580","69","73","31","42","125"
"UG","Uganda","42862958","70","72","36","36","126"
"CV","Cape Verde","546388","70","72","34","38","126"
"GM","Gambia","2100568","71","71","44","27","127"
"IN","India","1339180127","71","71","26","45","127"
"ZW","Zimbabwe","16529904","72","70","39","31","128"
"UZ","Uzbekistan","32387200","72","70","27","43","128"
"TJ","Tajikistan","8921343","72","70","27","43","128"
"ST","Sao Tome and Principe","204327","72","70","25","45","128"
"RW","Rwanda","12208407","73","69","28","41","129"
"GH","Ghana","28833629","74","68","38","30","130"
"MG","Madagascar","25570895","75","66","27","39","132"
"KH","Cambodia","16005373","75","66","20","46","132"
"BT","Bhutan","807610","75","66","17","49","132"
"BJ","Benin","11175692","76","65","31","34","133"
"MZ","Mozambique","29668834","76","65","28","37","133"
"VN","Viet Nam","95540800","76","65","23","42","133"
"SL","Sierra Leone","7557212","77","64","39","25","134"
"SN","Senegal","15850567","77","64","32","32","134"
"BF","Burkina Faso","19193382","77","64","29","35","134"
"CI","Cote d'Ivoire (Ivory Coast)","24294750","77","64","28","36","134"
"GA","Gabon","2025137","77","64","25","39","134"
"DZ","Algeria","41318142","78","63","19","44","135"
"TM","Turkmenistan","5758075","78","63","17","46","135"
"MR","Mauritania","4420184","79","62","26","36","136"
"JO","Jordan","9702353","79","62","21","41","136"
"AO","Angola","29784193","80","61","25","36","137"
"LA","Laos","6858160","80","61","21","40","137"
"KM","Comoros","813912","80","61","19","42","137"
"HT","Haiti","10981229","80","61","18","43","137"
"TG","Togo","7797694","81","60","25","35","138"
"GQ","Equatorial Guinea","1267689","81","60","19","41","138"
"EG","Egypt","97553151","81","60","18","42","138"
"ML","Mali","18541980","82","59","31","28","139"
"NE","Niger","21477348","82","59","29","30","139"
"GN","Guinea","12717176","82","59","26","33","139"
"TD","Chad","14899994","82","59","23","36","139"
"BI","Burundi","10864245","82","59","21","38","139"
"GW","Guinea-Bissau","1861283","83","57","25","32","141"
"CM","Cameroon","24053727","83","57","19","38","141"
"CF","Central African Republic","4659080","83","57","19","38","141"
"DJ","Djibouti","956985","84","56","15","41","142"
"LR","Liberia","4731906","85","55","25","30","143"
"MM","Myanmar [Burma]","53370609","86","54","15","39","144"
"RK","Kosovo","1830700","86","54","15","39","144"
"LB","Lebanon","6082357","87","53","16","37","145"
"LK","Sri Lanka","21444000","87","53","15","38","145"
"NP","Nepal","29304998","87","53","13","40","145"
"CG","Congo","5260750","88","52","15","37","146"
"CD","Congo (Dem. Rep.)","81339988","88","52","15","37","146"
"SS","South Sudan","12575714","88","52","15","37","146"
"KP","North Korea","25490965","89","51","11","40","147"
"NG","Nigeria","190886311","90","50","23","27","148"
"BD","Bangladesh","164669751","90","50","18","32","148"
"ET","Ethiopia","104957438","90","50","12","38","148"
"ER","Eritrea","4474690","90","50","12","38","148"
"LY","Libya","6374616","91","49","13","36","149"
"IR","Iran","81162788","91","49","12","37","149"
"PS","Palestinian Territories","4436411","92","48","14","34","150"
"SD","Sudan","40533330","92","48","11","37","150"
"YE","Yemen","28250420","93","44","11","33","154"
"PK","Pakistan","197015955","94","42","9","33","156"
"SO","Somalia","14742523","95","41","10","31","157"
"SY","Syria","18269868","96","40","8","32","158"
"IQ","Iraq","38274618","97","37","6","31","161"
"AF","Afghanistan","35530081","98","35","5","30","163"
